anguished :: мученический
entreating :: умоляющий
to puff :: дымить
fraternity :: братство / община
to entrust :: доверять
to resign oneself to :: смириться с неизбежным фактом
viciously :: угрожающе
eerie :: жуткий
to stash it away :: копить
calamity :: беда
to holler :: кричать
hoarse :: хрипло
voraciously :: взахлеб / жадно
to gnaw :: грызть
incessantly :: непрестанно
to stammer :: заикаться
to have the knack :: быть способным
to rectify :: исправлять
carnal :: плотский
to whisk :: забирать
to furgle :: шумно заниматься сексом
haste :: поспешность
wisecrack :: острота / шпилька
to be laid up :: лежать больным
haggard :: изможденный
perilously :: опасно
remedy :: мера (против чего-либо)
to hurl :: швырять
to tiptoe :: красться
pale :: бледный
rancor :: ненависть
to spurn :: пинать
fervor :: рвение
to wince :: вздрагивать
predilection :: склонность
dope :: наркоман
earnest :: искренний
conscientious :: добросовестный
bigotry :: нетерпимость
to tear :: разорвать
to gnash :: скрежетать
gust :: порыв
to creep into :: закрасться
tart :: уличная девка
to fling down :: сбросить
plump :: пухлый
sluggish :: медлительный
to grope :: нащупывать
flair for :: врожденная способность
pennant :: флаг части
to lug :: волочь
blistering :: накаленный
inconceivable :: немыслимо
to pout :: дуться
unsavory :: неприятный
sanguine :: уверенный в успехе
rapture :: восторг
thigh :: бедро
chortle :: хихикать
schmuck :: тупица
flagellation :: порка
to bellow :: орать / реветь
gingerly :: осторожно
mortified :: сгорающий от стыда
steely :: стальной / суровый
gaze :: вгляд
belch :: столб огня
to jeer :: язвить / насмехаться
solitude :: уединение
to recoil :: отпрянуть
ailing :: болезненный
gaunt :: худощавый
without faltering :: не моргнув глазом
vanquished :: побежденный
desiccated :: иссхоший
enfeebled :: ослабленный
grime :: сажа
moiling sky :: тяжелое небо
dreary :: тоскливый / унылый
chalky :: белесый
nuisance :: неудобство
tedious :: нудно / утомительно
meager :: скромный
mediocre :: посредственный
lanky :: долговязый
sober :: здравый
loose :: распутный
outspoken :: искренний
to whine :: ныть / скулить
to whimper :: хныкать / завывать
to wheedle :: пресмыкаться
to extort :: вымогать
devout :: набожный
pulpit :: трибуна
ardor :: пыл
wit :: ум
to leap :: прыгать / скакать
flagrant :: чудовищный
to brood :: ломать голову
morose :: угрюмый (более поэт)
inscrutable :: непроницаемый
animosity :: враждебность
to shiver :: трястись
lamentably :: печально
fluttery :: полный волнения
embroidered :: вышитый
nosegay :: букетик цветов
to gape :: смотреть в изумлениии
pendulous jaw :: отвисшая челюсть
meekly :: покорно / кротко
tugging :: тяга
to cower :: съежиться
petrified :: застывший
quivering :: трепещущий
to forge :: фабриковать
awe :: ужас
lenient :: снисходительный
delinquent :: провинившийся
to pertain :: принадлежать
despondent :: отчайявшийся
uninhibited :: несдерживаемый
so smth with gusto :: делать что-то с полной отдачей
to confide :: сообщать по секрету
to say stiffly :: сказать сухо
brisk :: живой / быстрый / порывистый
pudgy :: низенький и толстый
to smack :: причмокнуть
crisply :: решительно
to moan :: стенать
circumspect :: осмотрительный
mishap :: неудача
balefully :: пагубно
rim :: оправа
flamboyant :: бросающийся в глаза
jaunty :: бойкий / живой (устар)
to saunter :: прогуливаться
to elbow :: толкать
to trip :: ставить подножку
to maul :: растерзать
howling :: ревущий
mob :: толпа
foul :: грязный
frenzied :: бешеный
to bludgeon :: бить (ручным оружием)
compulsion :: мания
to trample :: топтать
to pummel :: бить / колотить (кулаками)
ditch :: канава
to slither :: скользить
to clamber :: карабкаться
to stagger :: идти шатаясь
hoot :: освистывание
to pelt :: забрасывать
paramount :: первостепенный
abrasion :: ссадина
conscience :: совесть
recluse :: затворник
disreputable :: дискредитирующий
to forfeit :: утрачивать
groan :: охать
snide :: подлый
stockade :: военная тюрьма
revulsion :: отвращение
disconsolate :: безутешный
listlessness :: неохота
pinched :: худой
consternation :: ужас
to yawn :: зевать
gloatingly :: злорадно
embittered :: озлобленный
resentment :: негодование
scornfully :: презрительно
cohort :: сторонник
pledge :: обет
allegiance :: верность
timid :: застенчивый
outcry :: гневный протест
scrupulously :: добросовестно
predicament :: затруднение
petulantly :: недовольно
disillusioned :: разочарованный
treacherous :: предательский
to grovel at feet :: валяться в ногах
solemn :: серьезный / внушительный
to slip :: скользить
stampede :: панический страх
awning :: навес
to ruminate :: раздумывать
vividly :: живо
to delineate :: очерчивать
forwardmost :: самый передний
to tug :: тащить с усилием воли
scrawny :: щуплый
to squint :: косить
martyred :: замученный
amiable :: любезный
prick :: болван
aghast :: ошеломленный
heady :: безрассудный
attainment :: приобретение
livid :: мертвенно-бледный
condemnation :: осуждение
to snarl :: ощериться
vehemently :: рьяно
furtively :: украдкой
dubiously :: сомнительно
wraith :: привидение
droop :: повесить (голову)
morbid :: нездоровый
glum :: хмурый / угрюмый
to sidle up :: подлизываться
to jerk :: резко дергать
clutching :: вцепившийся
to startle :: испугать
affront :: обида
vindictive :: мстительный
to shriek :: вскрикнуть
sibilant :: свистящий
indignantly :: негодующе
slit :: прорезанный
trench :: траншея
reeling :: неустойчивый
splendid :: великолепный
to conjecture :: предполагать
startled :: испуганный
soberly :: рассудительно
lithe :: гибкий
countenance :: выражение лица
perplexing :: озадачивающий
stuffy :: чванливый
to dissuade :: отговорить
frenetic :: маниакальный
to be elated :: быть ликующим
blunt rebuke :: грубый упрек
blunt :: тупой
to skulk :: прятаться
repudiation :: отрицание (долгов)
smarting :: болезненный / жгучий
dejection :: уныние
stocky :: коренастый
flaccid :: вялый
paunch :: брюшко
rebuttal :: опровержение
wanly :: слабо / несмело
frail :: хрупкий / хилый
jubilant :: торжествующий
sweep :: взмах
desolation :: опустошение / разрушение
dolorously :: страдающе
to roost :: сидеть на насесте
insensate :: бездушный / безчуственный
bereft of :: лишенный чего-либо
shivering :: дрожащий / трепещущий
buzzard :: старина / старый хрен
ponderous :: увесистый
primeval :: первобытный
lull :: штиль
imbued with :: насыщенный чем-либо
pus :: гной
wearily :: устало
to caress :: ласкать / гладить
lint :: лён
navel :: пуп
apprehensively :: боязливо
hushed :: приглушенный
gurgle :: журчание
reticently :: немногословно
sonorously :: звучно
plump :: полный / пухлый
orbicular :: круглый
beseechingly :: моляще
deaf :: глухой
voluminous :: объемистый
to shy :: отпрянуть
gasp :: одышка
rapturous :: восхищенный
dumbfound :: огорошить / ошеломить
contentment :: удовлетворение
to dread :: страшиться
jagged :: зазубренный
gash :: прорезь
lacquered :: лакированный
waterlogged :: затопленный
tawdry :: кричащий / безвкусный
to throb :: пульсировать / колебаться
shrill :: пронзительный
clamor :: шум / крики
serenely :: спокойно / невозмутимо
whorl :: завиток
raving lunatic :: буйный сумасшедший
to string out :: растянуть
tortuous :: извилистый
squirming :: изгибающийся
to flap off :: отгонять
to billow :: вздыматься / клубиться
tremulous :: робкий/ уязвимый
burden :: ноша
to flare :: сверкнуть / вспыхнуть
to gyrate :: крутиться
to flutter :: трепетать / колыхаться
vivid :: яркий / живой
shred :: клочок
barrenly :: скучно
listless :: вялый / апатичный
sticky :: жаркий и влажный
mellifluously :: сладкозвучно
insidious :: вероломный / предательский
envy :: зависть
prurient :: похотливый
svelte :: стройный / гибкий
filmy :: покрытый дымкой
clinging :: облегающий
garment :: предмет одежды / наряд
opalescent :: опаловый / перламутровый
lace :: ажурный
fragrant :: ароматный / душистый
corpulent :: тучный / жирный
stir :: суматоха
listlessly :: апатично / равнодушно
sallow :: желтушный
hale :: здоровый / крепкий
statuesque :: величавый / статный
irrepressible :: неугомонный
affectionate :: нежный / ласковый
vitality :: жизненность / живость
to frown :: хмуриться
daze :: изумление / оцепенение
stinging :: жгучий / острый
to clutch :: ухватиться
bewilderment :: смущение / замешательство
to gauge smn eyes out :: выдавить глаза
disdain :: презрение /пренебрежение
fierce :: свирепый / лютый
guttural :: гортанный
scornful :: презрительный / пренебрежительный
disgusted :: полный отвращения
oath :: клятва / проклятие (устар)
to stride :: шагать
handkerchief :: носовой платок
to clout :: дать затрещину
somnolently :: сонно
swelling :: набухающий / вздымающийся
to meander :: блуждать
hangdog :: расстроенный (вид)
mirthfully :: с удовлетворением
lusty :: чувственный / эенергичный
zeal :: рвение / пыл
to crack :: ударить
tremor :: дрожь
dignity :: достоинство
grace :: грация / такт
to choke :: подавиться
gutter :: желоб / сточная канава
curb :: край тротуара
strident :: шумный / крикливый
impetuously :: имульсивно / безоглядно
sweltering :: знойный / душный
sordid :: отвратительный / омерзительный
leer :: косой взгляд
to take it on the lam :: удирать / уносить ноги
strangled :: сдавленный / придушенный
fornication :: блуд / внебрачная связь
twinge :: приступ
to scoff :: насмехаться / осмеивать / глумиться
bumpkin :: деревенщина / мужлан
clumsy :: неуклюжий / неповоротливый
bungling :: неумелый / бездарный
conceited :: самодовольный
uncouth :: бескультурный / неотосанный
hayseed :: провинциал
reverence :: почтение
warped :: извращенный
scatalogical :: туалетный (юмор)
to writhe :: корчиться (от боли)
stupefied :: задурманенный
blunderer :: недотепа
sheer :: полнейший / абсолютный
bungler :: головотяп
ashen :: пепельный
to ogle :: бросать взгляды
resentfully :: возмущенно
yokel :: деревенщина
halcyon :: тихий / безмятежный
idyll :: идиллия
pandemonium broke loose :: ад раззверся
to snoop :: лезть (в глаза с инструментом)
jubilantly :: ликующе
humility :: смирение
insouciantly :: беззаботно
glowering :: враждебный / сердитый
sullen :: угрюмый / печальный
brim :: край (шляпы)
lapel :: лацкан
funereal :: траурный
to wail :: причитать
to lumber :: громыхать
dashing :: удалой
dejected :: подавленный
poised :: уравновешенный
chagrined :: огорченный
complacent :: самодовольный
craven :: трус
swashbuckling :: сумасбродный
beefy :: крепкий / мускулистый
seizure :: приступ
apprehension :: опасение
impervious :: невосприимчивый
foppish :: тщеславный
adroitly :: ловко / искусно
unwittingly :: неосознанно / непреднамеренно
flattering :: лестный
disquieting :: беспокойный
indefatigable :: неутомимый
to berate :: ругать / бранить
valorous :: доблестный
to pounce :: цепляться
hoggishly :: с аппетитом
damp :: запотевший
despair :: отчаяние / безысходность
shrewdly :: проницательно
to persecute :: преследовать
to devise :: выдумать
to bewail :: сокрушаться / оплакивать
to lament :: плакать / стенать
bristle :: щетина
spongy :: губчатый / пористый
to tan :: загорать
tumultuous :: шумный / беспокойный
intimidated :: запуганный
vicissitude :: превратность
farinaceous :: мучнистый
tinted :: окрашенный
lavish :: щедрый / расточительный
contemplation :: размышление
oblong :: продолговатый
venomously :: ядовито
coarse :: грубый
blunder :: промах
witty :: остроумно
urbane :: утонченный
to extricate :: выпутываться
snappy :: быстрый / оживленный
ruggedly :: крепко
jovially :: весело / живо
to tramp :: идти тяжёлой поступью
lousy :: вшивый
knuckle :: костяшка (пальца)
to fraternize :: брататься
keen :: сильное (предчувствие)
premonition :: предчувствие
reticent :: молчаливый / скрытный
disguise :: маскировка / личина
fiery :: пламенный
stiffly :: скованно
vindictively :: мстительно
mournful :: унылый / скорбный
gloom :: мрак / тьма
conceivable :: возможный / вероятный
snicker :: сдавленный смешок
remorse :: сожаление
to heave :: издать (звук)
to construe :: толковать
cowardice :: трусость / малодушие
eloquence :: красноречие
dilapidated :: ветхий / дряхлый
pate :: макушка
splayed :: длинный / растянутый
curt :: краткий / отрывистый
derisive :: насмешливый / ироничный
midriff :: диафрагма (часть тела)
shirttail :: подол рубашки
slovenly :: неопрятный
girth :: комплекция
disdainful :: презрительный / надменный
crepuscular :: тусклый
dour :: суровый / непреклонный
mollified :: смягчившись
to glint :: сверкнуть (глаза)
revelry :: пирушка / гульба
contemptuous :: презрительный / пренебрежительный
jittery :: нервничающий
to germinate with new ideas :: порождать новые идеи
feverishly :: лихорадочно
to bridle :: сдержать
vexation :: досада / раздражение
seclusion :: заключение / уединение
truculently :: радражительно
ire :: раздражение
belligerently :: воинственно
malaise :: неудовлетворенность
subversive :: подрывной / провокационный
seditious :: бунтарский
odious :: мерзкий / гнусный
to huddle over :: склониться над
deliberation :: размышление
tangible :: осязаемый / ощутимый
suave :: учтивый
boorish :: хамский
chunky :: увесистый / толстенький
squat :: маленький / коренастый
delectable :: вкуснейший / аппетитный (попа)
intransigent :: бескомпромисный
sham :: подлог / притворство
pretension :: спесивость / претенциозность
homely :: простой / невыразительный
obese :: тучный / жирный
querulously :: ворчливо
jovial :: жизнерадостный
rubicund :: румяный
ostracize :: изгонять / подвергать остракизму
sullenly :: депрессивно
resplendent :: яркий / поразительный
tenement :: съемный (квартира)
merriment :: веселье
blasphemy :: кощунство / богохульство
preoccupation :: озабоченность
to budge :: двигаться с места
grunt :: хрюканье
wheeze :: сопение
vast :: безбрежный
fustian :: напыщенный
charade :: фарс / спектакль
aloofness :: отчужденность
to make out :: разглядеть
to mop :: протирать
rite :: обряд / ритуал
gloomily :: мрачно / подавленно
disconsolately :: безутешно
to shinny down :: слезать
to divulge :: раскрыть (тайну)
trepidation :: плохое предчувствие
cordiality :: радушие
vocation :: призвание
vivacious :: жизнерадостный
petite :: изящный / миниатюрный
tameless :: дикий / неукротимый
to torment :: мучить
inexorably :: безжалостно
dire :: ужасающий
hideous :: отвратительный
ghastly :: ужасный
revery :: греза / мечта
deceitful :: лживый / обманчивый
apparition :: привидение
to quarrel :: спорить
ruefully :: сочувственно
condolence :: соболезнование
despicably :: недостойно / жалко
remiss :: небрежный
to rescind :: отменять / аннулировать
covertly :: скрытно / исподволь
satiated :: пресыщенный
genial :: добродушный
magnanimous :: великодушный
flabbergasted :: ошарашенный
pimples :: прыщи
receding :: срезанный (подбородок)
with alacrity :: быстро / живо
sanctimonious :: ханжеский / лицемерный
firecracker :: хлопушка
to squirm :: извиваться
to feign :: симулировать
to console :: утешать
sternly :: строго / грозно
aversion :: отвращение / антипатия
bland :: пресный (еда)
ambivalent :: двойственный
to digress :: отступать / отходить (от темы)
to pinch :: сжимать
ravish :: насиловать
to limp :: хромать
nausea :: тошнота
dizziness :: головокружение
morsel :: кусочек
to assuage :: облегчить / унять
bosom :: грудь
persecution :: преследование
incensed :: возмущенный
snigger :: смешок
lewdly :: похотливо
snobbery :: снобизм
squalid :: убогий / запущенный
indignity :: унижение / неуважение
drearily :: безрадостно
mischief :: озорство
to clench :: сжимать (кулаки)
elation :: восторг
fastidious :: щепетильный
turgid :: высокопарный
stilted :: напыщенный
deplorable :: позорный
stringent :: строгий / точный
incumbent upon :: возложенный на
reluctance :: нежелание
glibly :: без запинки
to urge :: понуждать
spunk :: храбрость / мужество
to relent :: смягчиться / пойти на попятный
squinting :: смотря искоса
titillating :: доставляющий удовольствие
adulation :: лесть / преклонение
condescendingly :: снисходительно
consolation :: утешение
ineptitude :: неумелость
demurely :: скромно
incorrigible :: неисправимый (человек)
callipygous :: красивая (именно задница)
solace :: покой / утешение
sedation :: успокоение
to prattle :: болтать / судачить
to repent :: раскаиваться
rap :: удар / хлопок
capricious :: капризный
dingy :: тусклый / выцветший
dull :: тупой / унылый
deluded :: заблуждающийся
obtuse :: тупой / глупый
boisterous :: шумный / разбитной
groin :: пах
shattered :: раскуроченный / разбитый в дребезги
dryly :: сухим тоном
incredulous :: скептический / недоверчивый
indignation :: возмущение / негодование
exasperation :: раздражение
hustling :: занятие проституцией
derision :: издевка / глумление
to persevere :: упорно продолжать
